{
  "images": {
    "0": "empty_block.png",
    "1": "wall1.png",
    "2": "hero.png",
    "3": "scared.png",
    "4": "chest.png",
    "5": "wall2.png",
    "6": "aggressive.png",
    "7": "passive.png"
  },
  "cells_amount": [30, 22],
  "map": {
    "cell_types": [
      "1","1","1","1","1","1","1","1","1","1","1","1","1","1","1","1","1","1","1","1","1","1","1","1","1","1","1","1","1","1",
      "1","1","1","1","1","1","1","1","1","1","1","1","1","1","1","1","1","1","1","1","1","1","1","1","1","1","1","1","1","1",
      "1","1","1","1","1","1","1","1","1","1","1","1","1","1","1","1","1","1","1","1","1","1","1","1","1","1","1","1","1","1",
      "1","1","1","0","0","0","0","0","0","1","1","1","1","1","0","0","0","0","0","0","1","1","1","1","0","0","0","1","1","1",
      "1","1","1","0","0","0","0","0","0","1","1","1","1","1","0","0","0","0","0","0","1","1","1","1","0","0","0","1","1","1",
      "1","1","1","0","0","0","0","0","0","0","0","0","0","0","0","0","0","0","0","0","0","0","0","0","0","0","0","1","1","1",
      "1","1","1","0","0","0","0","0","0","0","0","0","0","0","0","0","0","0","0","0","0","0","0","0","0","0","0","1","1","1",
      "1","1","1","0","0","0","0","0","0","1","1","1","1","1","0","0","0","0","0","0","1","1","1","1","0","0","0","1","1","1",
      "1","1","1","1","0","0","1","1","1","1","1","1","1","1","0","0","0","0","0","0","1","1","1","1","0","0","0","1","1","1",
      "1","1","1","1","0","0","1","1","1","1","1","1","1","1","1","0","0","1","1","1","1","1","1","1","1","1","1","1","1","1",
      "1","1","1","1","0","0","1","1","1","1","1","1","1","1","1","0","0","1","1","1","1","1","1","1","1","1","1","1","1","1",
      "1","1","1","1","0","0","1","1","1","1","1","1","1","1","1","0","0","1","1","1","1","1","1","1","1","1","1","1","1","1",
      "1","1","1","1","0","0","1","1","1","1","1","1","1","1","1","0","0","1","1","1","1","1","1","1","1","1","1","1","1","1",
      "1","1","1","1","0","0","1","1","1","1","1","1","1","1","1","0","0","1","1","1","1","1","1","1","1","1","1","1","1","1",
      "1","1","1","0","0","0","0","0","1","1","1","1","0","0","0","0","0","0","1","1","1","1","1","1","1","1","1","1","1","1",
      "1","1","1","0","0","0","0","0","0","0","0","0","0","0","0","0","0","0","1","1","1","1","1","1","1","1","1","1","1","1",
      "1","1","1","0","0","0","0","0","0","0","0","0","0","0","0","0","0","0","1","1","1","1","1","1","1","1","1","1","1","1",
      "1","1","1","0","0","0","0","0","1","1","1","1","0","0","0","0","0","0","1","1","1","1","1","1","1","1","1","1","1","1",
      "1","1","1","0","0","0","0","0","1","1","1","1","0","0","0","0","0","0","1","1","1","1","1","1","1","1","1","1","1","1",
      "1","1","1","1","1","1","1","1","1","1","1","1","1","1","1","1","1","1","1","1","1","1","1","1","1","1","1","1","1","1",
      "1","1","1","1","1","1","1","1","1","1","1","1","1","1","1","1","1","1","1","1","1","1","1","1","1","1","1","1","1","1",
      "1","1","1","1","1","1","1","1","1","1","1","1","1","1","1","1","1","1","1","1","1","1","1","1","1","1","1","1","1","1"
    ],
    "cell_images": [
      "5","5","5","5","5","5","5","5","5","5","5","5","5","5","5","5","5","5","5","5","5","5","5","5","5","5","5","5","5","5",
      "5","5","5","5","5","5","5","5","5","5","5","5","5","5","5","5","5","5","5","5","5","5","5","5","5","5","5","5","5","5",
      "5","5","1","1","1","1","1","1","1","1","5","5","5","1","1","1","1","1","1","1","1","5","5","1","1","1","1","1","5","5",
      "5","5","1","0","0","0","0","0","0","1","5","5","5","1","0","0","0","0","0","0","1","5","5","1","0","0","0","1","5","5",
      "5","5","1","0","0","0","0","0","0","1","1","1","1","1","0","0","0","0","0","0","1","1","1","1","0","0","0","1","5","5",
      "5","5","1","0","0","0","0","0","0","0","0","0","0","0","0","0","0","0","0","0","0","0","0","0","0","0","0","1","5","5",
      "5","5","1","0","0","0","0","0","0","0","0","0","0","0","0","0","0","0","0","0","0","0","0","0","0","0","0","1","5","5",
      "5","5","1","0","0","0","0","0","0","1","1","1","1","1","0","0","0","0","0","0","1","1","1","1","0","0","0","1","5","5",
      "5","5","1","1","0","0","1","1","1","1","5","5","5","1","0","0","0","0","0","0","1","5","5","1","0","0","0","1","5","5",
      "5","5","5","1","0","0","1","5","5","5","5","5","5","1","1","0","0","1","1","1","1","5","5","1","1","1","1","1","5","5",
      "5","5","5","1","0","0","1","5","5","5","5","5","5","5","1","0","0","1","5","5","5","5","5","5","5","5","5","5","5","5",
      "5","5","5","1","4","0","1","5","5","5","5","5","5","5","1","0","0","1","5","5","5","5","5","5","5","5","5","5","5","5",
      "5","5","5","1","0","0","1","5","5","5","5","5","5","5","1","0","0","1","5","5","5","5","5","5","5","5","5","5","5","5",
      "5","5","1","1","0","0","1","1","1","5","5","1","1","1","1","0","0","1","1","5","5","5","5","5","5","5","5","5","5","5",
      "5","5","1","0","0","0","0","0","1","1","1","1","0","0","0","0","0","0","1","5","5","5","5","5","5","5","5","5","5","5",
      "5","5","1","0","0","0","0","0","0","0","0","0","0","0","0","0","0","0","1","5","5","5","5","5","5","5","5","5","5","5",
      "5","5","1","0","0","0","0","0","0","0","0","0","0","0","0","0","0","0","1","5","5","5","5","5","5","5","5","5","5","5",
      "5","5","1","0","0","0","0","0","1","1","1","1","0","0","0","0","0","0","1","5","5","5","5","5","5","5","5","5","5","5",
      "5","5","1","0","0","0","0","0","1","5","5","1","0","0","0","0","0","0","1","5","5","5","5","5","5","5","5","5","5","5",
      "5","5","1","1","1","1","1","1","1","5","5","1","1","1","1","1","1","1","1","5","5","5","5","5","5","5","5","5","5","5",
      "5","5","5","5","5","5","5","5","5","5","5","5","5","5","5","5","5","5","5","5","5","5","5","5","5","5","5","5","5","5",
      "5","5","5","5","5","5","5","5","5","5","5","5","5","5","5","5","5","5","5","5","5","5","5","5","5","5","5","5","5","5"
    ]
  },
  "hero": {
    "position" : [15, 12],
    "image_key" : "2",
    "health": 100
  },
  "enemies": [
    {
      "position" : [4, 4],
      "health": 25,
      "image_key": "3",
      "strategy": "coward",
      "damage": 10,
      "exp_gain": 70,
      "scare_radius": 5
    },
    {
      "position" : [3, 3],
      "health": 15,
      "image_key": "6",
      "strategy": "aggressive",
      "damage": 15,
      "exp_gain": 30,
      "attack_radius": 3
    },
    {
      "position" : [3, 4],
      "health": 15,
      "image_key": "7",
      "strategy": "passive",
      "damage": 15,
      "exp_gain": 70
    },
    {
      "position" : [5, 4],
      "health": 15,
      "image_key": "7",
      "strategy": "passive",
      "damage": 15,
      "exp_gain": 200
    }
  ]
}